kitaplar	kitap
kitapları	kitap
kitabın	kitap
kitabı	kitap
kitaba	kitap
kitapta	kitap
kitaptan	kitap
kitabım	kitap
kitabımız	kitap
evler	ev
evleri	ev
evin	ev
evi	ev
eve	ev
evde	ev
evden	ev
evim	ev
evimiz	ev
insanlar	insan
insanları	insan
insanın	insan
insanı	insan
insana	insan
insanda	insan
insandan	insan
çocuklar	çocuk
çocukları	çocuk
çocuğun	çocuk
çocuğu	çocuk
çocuğa	çocuk
çocukta	çocuk
çocuktan	çocuk
kadınlar	kadın
kadınları	kadın
kadının	kadın
kadınları	kadın
kadına	kadın
kadında	kadın
kadından	kadın
erkekler	erkek
erkekleri	erkek
erkeğin	erkek
erkeği	erkek
erkeğe	erkek
erkekte	erkek
erkekten	erkek
günler	gün
günleri	gün
günün	gün
günü	gün
güne	gün
günde	gün
günden	gün
yıllar	yıl
yılları	yıl
yılın	yıl
yılı	yıl
yıla	yıl
yılda	yıl
yıldan	yıl
aylar	ay
ayları	ay
ayın	ay
ayı	ay
aya	ay
ayda	ay
aydan	ay
saatler	saat
saatleri	saat
saatin	saat
saati	saat
saate	saat
saatte	saat
saattan	saat
şehirler	şehir
şehirleri	şehir
şehrin	şehir
şehri	şehir
şehre	şehir
şehirde	şehir
şehirden	şehir
ülkeler	ülke
ülkeleri	ülke
ülkenin	ülke
ülkeyi	ülke
ülkeye	ülke
ülkede	ülke
ülkeden	ülke
dünyalar	dünya
dünyaları	dünya
dünyanın	dünya
dünyayı	dünya
dünyaya	dünya
dünyada	dünya
dünyadan	dünya
okullар	okul
okulları	okul
okulun	okul
okulu	okul
okula	okul
okulda	okul
okuldan	okul
geliyorum	gel
geliyorsun	gel
geliyor	gel
geliyoruz	gel
geliyorsunuz	gel
geliyorlar	gel
geldim	gel
geldin	gel
geldi	gel
geldik	gel
geldiniz	gel
geldiler	gel
geleceğim	gel
geleceksin	gel
gelecek	gel
geleceğiz	gel
geleceksiniz	gel
gelecekler	gel
gittim	git
gittin	git
gitti	git
gittik	git
gittiniz	git
gittiler	git
gidiyorum	git
gidiyorsun	git
gidiyor	git
gidiyoruz	git
gidiyorsunuz	git
gidiyorlar	git
gideceğim	git
gideceksin	git
gidecek	git
gideceğiz	git
gideceksiniz	git
gidecekler	git
yaptım	yap
yaptın	yap
yaptı	yap
yaptık	yap
yaptınız	yap
yaptılar	yap
yapıyorum	yap
yapıyorsun	yap
yapıyor	yap
yapıyoruz	yap
yapıyorsunuz	yap
yapıyorlar	yap
yapacağım	yap
yapacaksın	yap
yapacak	yap
yapacağız	yap
yapacaksınız	yap
yapacaklar	yap
aldım	al
aldın	al
aldı	al
aldık	al
aldınız	al
aldılar	al
alıyorum	al
alıyorsun	al
alıyor	al
alıyoruz	al
alıyorsunuz	al
alıyorlar	al
alacağım	al
alacaksın	al
alacak	al
alacağız	al
alacaksınız	al
alacaklar	al
verdim	ver
verdin	ver
verdi	ver
verdik	ver
verdiniz	ver
verdiler	ver
veriyorum	ver
veriyorsun	ver
veriyor	ver
veriyoruz	ver
veriyorsunuz	ver
veriyorlar	ver
vereceğim	ver
vereceksin	ver
verecek	ver
vereceğiz	ver
vereceksiniz	ver
verecekler	ver
okudum	oku
okudun	oku
okudu	oku
okuduk	oku
okudunuz	oku
okudular	oku
okuyorum	oku
okuyorsun	oku
okuyor	oku
okuyoruz	oku
okuyorsunuz	oku
okuyorlar	oku
okuyacağım	oku
okuyacaksın	oku
okuyacak	oku
okuyacağız	oku
okuyacaksınız	oku
okuyacaklar	oku
yazdım	yaz
yazdın	yaz
yazdı	yaz
yazdık	yaz
yazdınız	yaz
yazdılar	yaz
yazıyorum	yaz
yazıyorsun	yaz
yazıyor	yaz
yazıyoruz	yaz
yazıyorsunuz	yaz
yazıyorlar	yaz
yazacağım	yaz
yazacaksın	yaz
yazacak	yaz
yazacağız	yaz
yazacaksınız	yaz
yazacaklar	yaz
gördüm	gör
gördün	gör
gördü	gör
gördük	gör
gördünüz	gör
gördüler	gör
görüyorum	gör
görüyorsun	gör
görüyor	gör
görüyoruz	gör
görüyorsunuz	gör
görüyorlar	gör
göreceğim	gör
göreceksin	gör
görecek	gör
göreceğiz	gör
göreceksiniz	gör
görecekler	gör
söyledim	söyle
söyledin	söyle
söyledi	söyle
söyledik	söyle
söylediniz	söyle
söylediler	söyle
söylüyorum	söyle
söylüyorsun	söyle
söylüyor	söyle
söylüyoruz	söyle
söylüyorsunuz	söyle
söylüyorlar	söyle
söyleyeceğim	söyle
söyleyeceksin	söyle
söyleyecek	söyle
söyleyeceğiz	söyle
söyleyeceksiniz	söyle
söyleyecekler	söyle
bildim	bil
bildin	bil
bildi	bil
bildik	bil
bildiniz	bil
bildiler	bil
biliyorum	bil
biliyorsun	bil
biliyor	bil
biliyoruz	bil
biliyorsunuz	bil
biliyorlar	bil
bileceğim	bil
bileceksin	bil
bilecek	bil
bileceğiz	bil
bileceksiniz	bil
bilecekler	bil
istedim	iste
istedin	iste
istedi	iste
istedik	iste
istediniz	iste
istediler	iste
istiyorum	iste
istiyorsun	iste
istiyor	iste
istiyoruz	iste
istiyorsunuz	iste
istiyorlar	iste
isteyeceğim	iste
isteyeceksin	iste
isteyecek	iste
isteyeceğiz	iste
isteyeceksiniz	iste
isteyecekler	iste
oldum	ol
oldun	ol
oldu	ol
olduk	ol
oldunuz	ol
oldular	ol
oluyorum	ol
oluyorsun	ol
oluyor	ol
oluyoruz	ol
oluyorsunuz	ol
oluyorlar	ol
olacağım	ol
olacaksın	ol
olacak	ol
olacağız	ol
olacaksınız	ol
olacaklar	ol
büyükler	büyük
büyükleri	büyük
büyüğün	büyük
büyüğü	büyük
büyüğe	büyük
küçükler	küçük
küçükleri	küçük
küçüğün	küçük
küçüğü	küçük
küçüğe	küçük
güzeller	güzel
güzelleri	güzel
güzelin	güzel
güzeli	güzel
güzele	güzel
iyiler	iyi
iyileri	iyi
iyinin	iyi
iyiyi	iyi
iyiye	iyi
kötüler	kötü
kötüleri	kötü
kötünün	kötü
kötüyü	kötü
kötüye	kötü
yeniler	yeni
yenileri	yeni
yeninin	yeni
yeniyi	yeni
yeniye	yeni
eskileri	eski
eskilerin	eski
eskinin	eski
eskiyi	eski
eskiye	eski
benimle	ben
benden	ben
bana	ben
beni	ben
bende	ben
benim	ben
senin	sen
seni	sen
sana	sen
sende	sen
senden	sen
seninle	sen
onun	o
onu	o
ona	o
onda	o
ondan	o
onunla	o
bizim	biz
bizi	biz
bize	biz
bizde	biz
bizden	biz
bizimle	biz
sizin	siz
sizi	siz
size	siz
sizde	siz
sizden	siz
sizinle	siz
onların	onlar
onları	onlar
onlara	onlar
onlarda	onlar
onlardan	onlar
onlarla	onlar
bunlar	bu
bunları	bu
bunların	bu
bunlara	bu
bunlardan	bu
şunlar	şu
şunları	şu
şunların	şu
şunlara	şu
şunlardan	şu
